com.macro.mall.model.CmsHelpCategoryExample	[com.macro.mall.model.CmsHelpCategoryExample::java.lang.String orderByClause, com.macro.mall.model.CmsHelpCategoryExample::clear():void, com.macro.mall.model.CmsHelpCategoryExample::boolean distinct]
com.macro.mall.model.CmsHelpExample	[com.macro.mall.model.CmsHelpExample::java.lang.String orderByClause, com.macro.mall.model.CmsHelpExample::clear():void, com.macro.mall.model.CmsHelpExample::boolean distinct]
com.macro.mall.model.CmsMemberReportExample	[com.macro.mall.model.CmsMemberReportExample::java.lang.String orderByClause, com.macro.mall.model.CmsMemberReportExample::clear():void, com.macro.mall.model.CmsMemberReportExample::boolean distinct]
com.macro.mall.model.CmsPrefrenceAreaExample	[com.macro.mall.model.CmsPrefrenceAreaExample::java.lang.String orderByClause, com.macro.mall.model.CmsPrefrenceAreaExample::clear():void, com.macro.mall.model.CmsPrefrenceAreaExample::boolean distinct]
com.macro.mall.model.CmsPrefrenceAreaProductRelationExample	[com.macro.mall.model.CmsPrefrenceAreaProductRelationExample::java.lang.String orderByClause, com.macro.mall.model.CmsPrefrenceAreaProductRelationExample::clear():void, com.macro.mall.model.CmsPrefrenceAreaProductRelationExample::boolean distinct]
com.macro.mall.model.CmsSubjectCategoryExample	[com.macro.mall.model.CmsSubjectCategoryExample::java.lang.String orderByClause, com.macro.mall.model.CmsSubjectCategoryExample::clear():void, com.macro.mall.model.CmsSubjectCategoryExample::boolean distinct]
com.macro.mall.model.CmsSubjectCommentExample	[com.macro.mall.model.CmsSubjectCommentExample::java.lang.String orderByClause, com.macro.mall.model.CmsSubjectCommentExample::clear():void, com.macro.mall.model.CmsSubjectCommentExample::boolean distinct]
com.macro.mall.model.CmsSubjectExample	[com.macro.mall.model.CmsSubjectExample::java.lang.String orderByClause, com.macro.mall.model.CmsSubjectExample::clear():void, com.macro.mall.model.CmsSubjectExample::boolean distinct]
com.macro.mall.model.CmsSubjectProductRelationExample	[com.macro.mall.model.CmsSubjectProductRelationExample::java.lang.String orderByClause, com.macro.mall.model.CmsSubjectProductRelationExample::clear():void, com.macro.mall.model.CmsSubjectProductRelationExample::boolean distinct]
com.macro.mall.model.CmsTopicCategoryExample	[com.macro.mall.model.CmsTopicCategoryExample::java.lang.String orderByClause, com.macro.mall.model.CmsTopicCategoryExample::clear():void, com.macro.mall.model.CmsTopicCategoryExample::boolean distinct]
com.macro.mall.model.CmsTopicCommentExample	[com.macro.mall.model.CmsTopicCommentExample::java.lang.String orderByClause, com.macro.mall.model.CmsTopicCommentExample::clear():void, com.macro.mall.model.CmsTopicCommentExample::boolean distinct]
com.macro.mall.model.CmsTopicExample	[com.macro.mall.model.CmsTopicExample::java.lang.String orderByClause, com.macro.mall.model.CmsTopicExample::clear():void, com.macro.mall.model.CmsTopicExample::boolean distinct]
com.macro.mall.model.OmsCartItemExample	[com.macro.mall.model.OmsCartItemExample::java.lang.String orderByClause, com.macro.mall.model.OmsCartItemExample::clear():void, com.macro.mall.model.OmsCartItemExample::boolean distinct]
com.macro.mall.model.OmsCompanyAddressExample	[com.macro.mall.model.OmsCompanyAddressExample::java.lang.String orderByClause, com.macro.mall.model.OmsCompanyAddressExample::clear():void, com.macro.mall.model.OmsCompanyAddressExample::boolean distinct]
com.macro.mall.model.OmsOrderExample	[com.macro.mall.model.OmsOrderExample::java.lang.String orderByClause, com.macro.mall.model.OmsOrderExample::clear():void, com.macro.mall.model.OmsOrderExample::boolean distinct]
com.macro.mall.model.OmsOrderItemExample	[com.macro.mall.model.OmsOrderItemExample::java.lang.String orderByClause, com.macro.mall.model.OmsOrderItemExample::clear():void, com.macro.mall.model.OmsOrderItemExample::boolean distinct]
com.macro.mall.model.OmsOrderOperateHistoryExample	[com.macro.mall.model.OmsOrderOperateHistoryExample::java.lang.String orderByClause, com.macro.mall.model.OmsOrderOperateHistoryExample::clear():void, com.macro.mall.model.OmsOrderOperateHistoryExample::boolean distinct]
com.macro.mall.model.OmsOrderReturnApplyExample	[com.macro.mall.model.OmsOrderReturnApplyExample::java.lang.String orderByClause, com.macro.mall.model.OmsOrderReturnApplyExample::clear():void, com.macro.mall.model.OmsOrderReturnApplyExample::boolean distinct]
com.macro.mall.model.OmsOrderReturnReasonExample	[com.macro.mall.model.OmsOrderReturnReasonExample::java.lang.String orderByClause, com.macro.mall.model.OmsOrderReturnReasonExample::clear():void, com.macro.mall.model.OmsOrderReturnReasonExample::boolean distinct]
com.macro.mall.model.OmsOrderSettingExample	[com.macro.mall.model.OmsOrderSettingExample::java.lang.String orderByClause, com.macro.mall.model.OmsOrderSettingExample::clear():void, com.macro.mall.model.OmsOrderSettingExample::boolean distinct]
com.macro.mall.model.PmsAlbumExample	[com.macro.mall.model.PmsAlbumExample::java.lang.String orderByClause, com.macro.mall.model.PmsAlbumExample::clear():void, com.macro.mall.model.PmsAlbumExample::boolean distinct]
com.macro.mall.model.PmsAlbumPicExample	[com.macro.mall.model.PmsAlbumPicExample::java.lang.String orderByClause, com.macro.mall.model.PmsAlbumPicExample::clear():void, com.macro.mall.model.PmsAlbumPicExample::boolean distinct]
com.macro.mall.model.PmsBrandExample	[com.macro.mall.model.PmsBrandExample::java.lang.String orderByClause, com.macro.mall.model.PmsBrandExample::clear():void, com.macro.mall.model.PmsBrandExample::boolean distinct]
com.macro.mall.model.PmsCommentExample	[com.macro.mall.model.PmsCommentExample::java.lang.String orderByClause, com.macro.mall.model.PmsCommentExample::clear():void, com.macro.mall.model.PmsCommentExample::boolean distinct]
com.macro.mall.model.PmsCommentReplayExample	[com.macro.mall.model.PmsCommentReplayExample::java.lang.String orderByClause, com.macro.mall.model.PmsCommentReplayExample::clear():void, com.macro.mall.model.PmsCommentReplayExample::boolean distinct]
com.macro.mall.model.PmsFeightTemplateExample	[com.macro.mall.model.PmsFeightTemplateExample::java.lang.String orderByClause, com.macro.mall.model.PmsFeightTemplateExample::clear():void, com.macro.mall.model.PmsFeightTemplateExample::boolean distinct]
com.macro.mall.model.PmsMemberPriceExample	[com.macro.mall.model.PmsMemberPriceExample::java.lang.String orderByClause, com.macro.mall.model.PmsMemberPriceExample::clear():void, com.macro.mall.model.PmsMemberPriceExample::boolean distinct]
com.macro.mall.model.PmsProductAttributeCategoryExample	[com.macro.mall.model.PmsProductAttributeCategoryExample::java.lang.String orderByClause, com.macro.mall.model.PmsProductAttributeCategoryExample::clear():void, com.macro.mall.model.PmsProductAttributeCategoryExample::boolean distinct]
com.macro.mall.model.PmsProductAttributeExample	[com.macro.mall.model.PmsProductAttributeExample::java.lang.String orderByClause, com.macro.mall.model.PmsProductAttributeExample::clear():void, com.macro.mall.model.PmsProductAttributeExample::boolean distinct]
com.macro.mall.model.PmsProductAttributeValueExample	[com.macro.mall.model.PmsProductAttributeValueExample::java.lang.String orderByClause, com.macro.mall.model.PmsProductAttributeValueExample::clear():void, com.macro.mall.model.PmsProductAttributeValueExample::boolean distinct]
com.macro.mall.model.PmsProductCategoryAttributeRelationExample	[com.macro.mall.model.PmsProductCategoryAttributeRelationExample::java.lang.String orderByClause, com.macro.mall.model.PmsProductCategoryAttributeRelationExample::clear():void, com.macro.mall.model.PmsProductCategoryAttributeRelationExample::boolean distinct]
com.macro.mall.model.PmsProductCategoryExample	[com.macro.mall.model.PmsProductCategoryExample::java.lang.String orderByClause, com.macro.mall.model.PmsProductCategoryExample::clear():void, com.macro.mall.model.PmsProductCategoryExample::boolean distinct]
com.macro.mall.model.PmsProductExample	[com.macro.mall.model.PmsProductExample::java.lang.String orderByClause, com.macro.mall.model.PmsProductExample::clear():void, com.macro.mall.model.PmsProductExample::boolean distinct]
com.macro.mall.model.PmsProductFullReductionExample	[com.macro.mall.model.PmsProductFullReductionExample::java.lang.String orderByClause, com.macro.mall.model.PmsProductFullReductionExample::clear():void, com.macro.mall.model.PmsProductFullReductionExample::boolean distinct]
com.macro.mall.model.PmsProductLadderExample	[com.macro.mall.model.PmsProductLadderExample::java.lang.String orderByClause, com.macro.mall.model.PmsProductLadderExample::clear():void, com.macro.mall.model.PmsProductLadderExample::boolean distinct]
com.macro.mall.model.PmsProductOperateLogExample	[com.macro.mall.model.PmsProductOperateLogExample::java.lang.String orderByClause, com.macro.mall.model.PmsProductOperateLogExample::clear():void, com.macro.mall.model.PmsProductOperateLogExample::boolean distinct]
com.macro.mall.model.PmsProductVertifyRecordExample	[com.macro.mall.model.PmsProductVertifyRecordExample::java.lang.String orderByClause, com.macro.mall.model.PmsProductVertifyRecordExample::clear():void, com.macro.mall.model.PmsProductVertifyRecordExample::boolean distinct]
com.macro.mall.model.PmsSkuStockExample	[com.macro.mall.model.PmsSkuStockExample::java.lang.String orderByClause, com.macro.mall.model.PmsSkuStockExample::clear():void, com.macro.mall.model.PmsSkuStockExample::boolean distinct]
com.macro.mall.model.SmsCouponExample	[com.macro.mall.model.SmsCouponExample::java.lang.String orderByClause, com.macro.mall.model.SmsCouponExample::clear():void, com.macro.mall.model.SmsCouponExample::boolean distinct]
com.macro.mall.model.SmsCouponHistoryExample	[com.macro.mall.model.SmsCouponHistoryExample::java.lang.String orderByClause, com.macro.mall.model.SmsCouponHistoryExample::clear():void, com.macro.mall.model.SmsCouponHistoryExample::boolean distinct]
com.macro.mall.model.SmsCouponProductCategoryRelationExample	[com.macro.mall.model.SmsCouponProductCategoryRelationExample::java.lang.String orderByClause, com.macro.mall.model.SmsCouponProductCategoryRelationExample::clear():void, com.macro.mall.model.SmsCouponProductCategoryRelationExample::boolean distinct]
com.macro.mall.model.SmsCouponProductRelationExample	[com.macro.mall.model.SmsCouponProductRelationExample::java.lang.String orderByClause, com.macro.mall.model.SmsCouponProductRelationExample::clear():void, com.macro.mall.model.SmsCouponProductRelationExample::boolean distinct]
com.macro.mall.model.SmsFlashPromotionExample	[com.macro.mall.model.SmsFlashPromotionExample::java.lang.String orderByClause, com.macro.mall.model.SmsFlashPromotionExample::clear():void, com.macro.mall.model.SmsFlashPromotionExample::boolean distinct]
com.macro.mall.model.SmsFlashPromotionLogExample	[com.macro.mall.model.SmsFlashPromotionLogExample::java.lang.String orderByClause, com.macro.mall.model.SmsFlashPromotionLogExample::clear():void, com.macro.mall.model.SmsFlashPromotionLogExample::boolean distinct]
com.macro.mall.model.SmsFlashPromotionProductRelationExample	[com.macro.mall.model.SmsFlashPromotionProductRelationExample::java.lang.String orderByClause, com.macro.mall.model.SmsFlashPromotionProductRelationExample::clear():void, com.macro.mall.model.SmsFlashPromotionProductRelationExample::boolean distinct]
com.macro.mall.model.SmsFlashPromotionSessionExample	[com.macro.mall.model.SmsFlashPromotionSessionExample::java.lang.String orderByClause, com.macro.mall.model.SmsFlashPromotionSessionExample::clear():void, com.macro.mall.model.SmsFlashPromotionSessionExample::boolean distinct]
com.macro.mall.model.SmsHomeAdvertiseExample	[com.macro.mall.model.SmsHomeAdvertiseExample::java.lang.String orderByClause, com.macro.mall.model.SmsHomeAdvertiseExample::clear():void, com.macro.mall.model.SmsHomeAdvertiseExample::boolean distinct]
com.macro.mall.model.SmsHomeBrandExample	[com.macro.mall.model.SmsHomeBrandExample::java.lang.String orderByClause, com.macro.mall.model.SmsHomeBrandExample::clear():void, com.macro.mall.model.SmsHomeBrandExample::boolean distinct]
com.macro.mall.model.SmsHomeNewProductExample	[com.macro.mall.model.SmsHomeNewProductExample::java.lang.String orderByClause, com.macro.mall.model.SmsHomeNewProductExample::clear():void, com.macro.mall.model.SmsHomeNewProductExample::boolean distinct]
com.macro.mall.model.SmsHomeRecommendProductExample	[com.macro.mall.model.SmsHomeRecommendProductExample::java.lang.String orderByClause, com.macro.mall.model.SmsHomeRecommendProductExample::clear():void, com.macro.mall.model.SmsHomeRecommendProductExample::boolean distinct]
com.macro.mall.model.SmsHomeRecommendSubjectExample	[com.macro.mall.model.SmsHomeRecommendSubjectExample::java.lang.String orderByClause, com.macro.mall.model.SmsHomeRecommendSubjectExample::clear():void, com.macro.mall.model.SmsHomeRecommendSubjectExample::boolean distinct]
com.macro.mall.model.UmsAdminExample	[com.macro.mall.model.UmsAdminExample::java.lang.String orderByClause, com.macro.mall.model.UmsAdminExample::clear():void, com.macro.mall.model.UmsAdminExample::boolean distinct]
com.macro.mall.model.UmsAdminLoginLogExample	[com.macro.mall.model.UmsAdminLoginLogExample::java.lang.String orderByClause, com.macro.mall.model.UmsAdminLoginLogExample::clear():void, com.macro.mall.model.UmsAdminLoginLogExample::boolean distinct]
com.macro.mall.model.UmsAdminPermissionRelationExample	[com.macro.mall.model.UmsAdminPermissionRelationExample::java.lang.String orderByClause, com.macro.mall.model.UmsAdminPermissionRelationExample::clear():void, com.macro.mall.model.UmsAdminPermissionRelationExample::boolean distinct]
com.macro.mall.model.UmsAdminRoleRelationExample	[com.macro.mall.model.UmsAdminRoleRelationExample::java.lang.String orderByClause, com.macro.mall.model.UmsAdminRoleRelationExample::clear():void, com.macro.mall.model.UmsAdminRoleRelationExample::boolean distinct]
com.macro.mall.model.UmsGrowthChangeHistoryExample	[com.macro.mall.model.UmsGrowthChangeHistoryExample::java.lang.String orderByClause, com.macro.mall.model.UmsGrowthChangeHistoryExample::clear():void, com.macro.mall.model.UmsGrowthChangeHistoryExample::boolean distinct]
com.macro.mall.model.UmsIntegrationChangeHistoryExample	[com.macro.mall.model.UmsIntegrationChangeHistoryExample::java.lang.String orderByClause, com.macro.mall.model.UmsIntegrationChangeHistoryExample::clear():void, com.macro.mall.model.UmsIntegrationChangeHistoryExample::boolean distinct]
com.macro.mall.model.UmsIntegrationConsumeSettingExample	[com.macro.mall.model.UmsIntegrationConsumeSettingExample::java.lang.String orderByClause, com.macro.mall.model.UmsIntegrationConsumeSettingExample::clear():void, com.macro.mall.model.UmsIntegrationConsumeSettingExample::boolean distinct]
com.macro.mall.model.UmsMemberExample	[com.macro.mall.model.UmsMemberExample::java.lang.String orderByClause, com.macro.mall.model.UmsMemberExample::clear():void, com.macro.mall.model.UmsMemberExample::boolean distinct]
com.macro.mall.model.UmsMemberLevelExample	[com.macro.mall.model.UmsMemberLevelExample::java.lang.String orderByClause, com.macro.mall.model.UmsMemberLevelExample::clear():void, com.macro.mall.model.UmsMemberLevelExample::boolean distinct]
com.macro.mall.model.UmsMemberLoginLogExample	[com.macro.mall.model.UmsMemberLoginLogExample::java.lang.String orderByClause, com.macro.mall.model.UmsMemberLoginLogExample::clear():void, com.macro.mall.model.UmsMemberLoginLogExample::boolean distinct]
com.macro.mall.model.UmsMemberMemberTagRelationExample	[com.macro.mall.model.UmsMemberMemberTagRelationExample::java.lang.String orderByClause, com.macro.mall.model.UmsMemberMemberTagRelationExample::clear():void, com.macro.mall.model.UmsMemberMemberTagRelationExample::boolean distinct]
com.macro.mall.model.UmsMemberProductCategoryRelationExample	[com.macro.mall.model.UmsMemberProductCategoryRelationExample::java.lang.String orderByClause, com.macro.mall.model.UmsMemberProductCategoryRelationExample::clear():void, com.macro.mall.model.UmsMemberProductCategoryRelationExample::boolean distinct]
com.macro.mall.model.UmsMemberReceiveAddressExample	[com.macro.mall.model.UmsMemberReceiveAddressExample::java.lang.String orderByClause, com.macro.mall.model.UmsMemberReceiveAddressExample::clear():void, com.macro.mall.model.UmsMemberReceiveAddressExample::boolean distinct]
com.macro.mall.model.UmsMemberRuleSettingExample	[com.macro.mall.model.UmsMemberRuleSettingExample::java.lang.String orderByClause, com.macro.mall.model.UmsMemberRuleSettingExample::clear():void, com.macro.mall.model.UmsMemberRuleSettingExample::boolean distinct]
com.macro.mall.model.UmsMemberStatisticsInfoExample	[com.macro.mall.model.UmsMemberStatisticsInfoExample::java.lang.String orderByClause, com.macro.mall.model.UmsMemberStatisticsInfoExample::clear():void, com.macro.mall.model.UmsMemberStatisticsInfoExample::boolean distinct]
com.macro.mall.model.UmsMemberTagExample	[com.macro.mall.model.UmsMemberTagExample::java.lang.String orderByClause, com.macro.mall.model.UmsMemberTagExample::clear():void, com.macro.mall.model.UmsMemberTagExample::boolean distinct]
com.macro.mall.model.UmsMemberTaskExample	[com.macro.mall.model.UmsMemberTaskExample::java.lang.String orderByClause, com.macro.mall.model.UmsMemberTaskExample::clear():void, com.macro.mall.model.UmsMemberTaskExample::boolean distinct]
com.macro.mall.model.UmsMenuExample	[com.macro.mall.model.UmsMenuExample::java.lang.String orderByClause, com.macro.mall.model.UmsMenuExample::clear():void, com.macro.mall.model.UmsMenuExample::boolean distinct]
com.macro.mall.model.UmsPermissionExample	[com.macro.mall.model.UmsPermissionExample::java.lang.String orderByClause, com.macro.mall.model.UmsPermissionExample::clear():void, com.macro.mall.model.UmsPermissionExample::boolean distinct]
com.macro.mall.model.UmsResourceCategoryExample	[com.macro.mall.model.UmsResourceCategoryExample::java.lang.String orderByClause, com.macro.mall.model.UmsResourceCategoryExample::clear():void, com.macro.mall.model.UmsResourceCategoryExample::boolean distinct]
com.macro.mall.model.UmsResourceExample	[com.macro.mall.model.UmsResourceExample::java.lang.String orderByClause, com.macro.mall.model.UmsResourceExample::clear():void, com.macro.mall.model.UmsResourceExample::boolean distinct]
com.macro.mall.model.UmsRoleExample	[com.macro.mall.model.UmsRoleExample::java.lang.String orderByClause, com.macro.mall.model.UmsRoleExample::clear():void, com.macro.mall.model.UmsRoleExample::boolean distinct]
com.macro.mall.model.UmsRoleMenuRelationExample	[com.macro.mall.model.UmsRoleMenuRelationExample::java.lang.String orderByClause, com.macro.mall.model.UmsRoleMenuRelationExample::clear():void, com.macro.mall.model.UmsRoleMenuRelationExample::boolean distinct]
com.macro.mall.model.UmsRolePermissionRelationExample	[com.macro.mall.model.UmsRolePermissionRelationExample::java.lang.String orderByClause, com.macro.mall.model.UmsRolePermissionRelationExample::clear():void, com.macro.mall.model.UmsRolePermissionRelationExample::boolean distinct]
com.macro.mall.model.UmsRoleResourceRelationExample	[com.macro.mall.model.UmsRoleResourceRelationExample::java.lang.String orderByClause, com.macro.mall.model.UmsRoleResourceRelationExample::clear():void, com.macro.mall.model.UmsRoleResourceRelationExample::boolean distinct]
